Alhajj (Elhajj), Reda	Professor	<a href="/info/cpsc/profiles/102-3622">Alhajj (Elhajj), Reda</a>	['Databases', 'Character Recognition', 'Data Mining', 'Web Databases']
Alim, Usman	Associate ProfessorDirector - Data Science (Comp Sci)	<a href="/info/cpsc/profiles/102-36723">Alim, Usman</a>	['Applications of Signal Processing to Computer Graphics and Visualization', 'Physically-based Modeling and Rendering', 'Global Illumination']
Arlitt, Martin	Adjunct Assistant Professor	<a href="/info/cpsc/profiles/102-3250">Arlitt, Martin</a>	[]
Aycock, John	Associate Professor	<a href="/info/cpsc/profiles/102-3531">Aycock, John</a>	[]
Barker, Ken	ProfessorAcademic Directors	<a href="/info/cpsc/profiles/102-3545">Barker, Ken</a>	[]
Birtwistle, Graham Mark	Professor Emeritus	<a href="/info/cpsc/profiles/102-3097">Birtwistle, Graham Mark</a>	[]
Boyd, Jeffrey Edwin	Associate ProfessorAssociate Head (Graduate Affairs)	<a href="/info/cpsc/profiles/102-3586">Boyd, Jeffrey Edwin</a>	['Computer Vision', 'Video', 'Motion', 'Optical Flow', 'Image Processing']
Brebner, Michael Alan	Associate Professor Emeritus	<a href="/info/cpsc/profiles/102-3093">Brebner, Michael Alan</a>	[]
Carpendale, Sheelagh	ProfessorTier I CRC- Info Visualisation	<a href="/info/cpsc/profiles/102-3216">Carpendale, Sheelagh</a>	['Human-Computer Interaction (HCI)', 'Graphics', 'Information Visualization']
Cockett, Robin	Professor	<a href="/info/cpsc/profiles/102-3538">Cockett, Robin</a>	['Distributive categories, restriction categories, linearly distributive categories, differential categories;', 'Categorical proof theory, semantics of computation, semantics of concurrency; categorical programming, quantum programming.']
Colijn, Anton Willem	Professor Emeritus	<a href="/info/cpsc/profiles/102-3089">Colijn, Anton Willem</a>	[]
Costa Sousa, Mario	Associate Professor	<a href="/info/cpsc/profiles/102-3239">Costa Sousa, Mario</a>	['Computer Graphics', 'Non-Photorealistic Rendering and Animation', 'Scientific Visualization']
Denzinger, Jorg	Associate Professor	<a href="/info/cpsc/profiles/102-3593">Denzinger, Jorg</a>	['Artificial Intelligence, Knowledge-Based Systems, Distributed Knowledge-Based Search, Machine Learning, Automated Deduction.', 'Multi-Agent Systems, Coordination and Cooperation Concepts, Learning of Cooperative Behavior, Collaborative Search, Learning Agents, Web Agents.']
Eberly, Wayne Michael	Professor	<a href="/info/cpsc/profiles/102-3510">Eberly, Wayne Michael</a>	['Algorithm Design & Analysis', 'Complexity of Computation', 'Sabbatical Leave', 'Dr. Wayne Eberly is on Sabbatical until Dec. 31, 2016']
Fong, Philip	Associate ProfessorDirector - Info Security Program	<a href="/info/cpsc/profiles/102-3710">Fong, Philip</a>	['Language-based Security', 'Access Control', 'Protection Technologies for Social Computing']
Gaines, Brian Ronald	Professor Emeritus	<a href="/info/cpsc/profiles/102-3117">Gaines, Brian Ronald</a>	[]
Gavrilova, Marina	ProfessorAssociate Head - R&SP	<a href="/info/cpsc/profiles/102-3440">Gavrilova, Marina</a>	['Computer Graphics', 'Image Processing', 'Computational Geometry', 'Biometrics', 'Geographical Information Systems', 'Computer Modeling and Simulation']
Ghaderi, Majid	Professor	<a href="/info/cpsc/profiles/102-3679">Ghaderi, Majid</a>	['Wireless Networks', 'Mobile Computing', 'Performance Evaluation']
Greenberg, Saul	Professor Emeritus	<a href="/info/cpsc/profiles/102-3143">Greenberg, Saul</a>	['Human-Computer Interaction (HCI)', 'Computer Supported Cooperative Work']
Hajizadeh, Yasin	Adjunct Associate Professor	<a href="/info/cpsc/profiles/102-5658">Hajizadeh, Yasin</a>	[]
Henry, Ryan	Assistant Professor	<a href="/info/cpsc/profiles/1-8764750">Henry, Ryan</a>	[]
Higham, Lisa	Professor Emeritus	<a href="/info/cpsc/profiles/102-3489">Higham, Lisa</a>	[]
Hill, David Roderic	Professor Emeritus	<a href="/info/cpsc/profiles/102-3091">Hill, David Roderic</a>	[]
Hoyer, Peter Christian	Associate Professor	<a href="/info/cpsc/profiles/102-3607">Hoyer, Peter Christian</a>	['Quantum Computation', 'Algorithms', 'Data Structures']
Imbert, Laurent	Adjunct Professor	<a href="/info/cpsc/profiles/101-152771">Imbert, Laurent</a>	[]
Jacob, Christian	Bioinformatics Program Director; ProfessorDepartment Head	<a href="/info/cpsc/profiles/102-3211">Jacob, Christian</a>	['Algorithms gleaned from Nature. Biocomputing. Bioinformatics.', 'Evolutionary Algorithms: genetic algorithms, genetic programming, evolution strategies.', 'Parallel rewrite systems and their evolution: Lindenmayer systems, cellular automata.', 'Modelling, simulation, and visualization of biological systems: ecosystems, swarm intelligence, developmental biology, genome programming, DNA computing.']
Jacobson Jr., Michael John	ProfessorDeputy Director - ISPIA	<a href="/info/cpsc/profiles/101-152834">Jacobson Jr., Michael John</a>	[]
Kawash, Jalal	Teaching Professor	<a href="/info/cpsc/profiles/102-3070">Kawash, Jalal</a>	['Distributed Systems, Distributed-Shared Memory, Memory Consistency Models, Internet-Caching, Programmability, Synchronization, Process Coordination, Critical Sections, Producer/Consumer Coordination, Web and Internet Computing, Mobile Virtual Communities']
Loose, Kenneth David	Associate Professor Emeritus	<a href="/info/cpsc/profiles/102-2567">Loose, Kenneth David</a>	[]
Maurer, Frank	Professor	<a href="/info/cpsc/profiles/102-3556">Maurer, Frank</a>	['Agile Methods', 'Web Engineering', 'Agile Usability', 'Test-Driven Development', 'Experience & Knowledge Management']
Oehlberg, Lora	Assistant ProfessorAssociate Head (C&O)	<a href="/info/cpsc/profiles/1-6140790">Oehlberg, Lora</a>	['Creativity Support Tools, Computer-Supported Cooperative Work, Human-Computer Interaction, Information Visualization']
Prusinkiewicz, Przemyslaw	Professor	<a href="/info/cpsc/profiles/102-3171">Prusinkiewicz, Przemyslaw</a>	['Modeling, Simulation and Visualization in Developmental Plant Biology: theory, computing methods, and models of specific phenomena;', 'Computational Biology of Multicellular Organisms;', 'Morphogenesis;', 'Computer Graphics: realistic image synthesis and geometric modeling; L-systems; Unconventional Computing Paradigms']
Reardon, Joel	Assistant Professor	<a href="/info/cpsc/profiles/1-7888685">Reardon, Joel</a>	[]
Rokne, Jon George	Professor	<a href="/info/cpsc/profiles/102-3447">Rokne, Jon George</a>	['Interval Analysis', 'Computer Graphics']
Ruhe, Guenther	Professor	<a href="/info/cpsc/profiles/102-3614">Ruhe, Guenther</a>	['Software Engineering Decision Support', 'Software Release Planning', 'COTS Selection', 'Software Project Management', 'Software Quality Management', 'Software Measurement', 'Process Modeling and Simulation', 'Empirical Software Engineering']
Safavi-Naeini, Reyhaneh	ProfessorNSERC/Telus IRC Info Security	<a href="/info/cpsc/profiles/102-3394">Safavi-Naeini, Reyhaneh</a>	['Cryptography', 'Network Security', 'Privacy Enhancing Technologies', 'Digital Rights Management']
Samavati, Faramarz	Professor	<a href="/info/cpsc/profiles/102-3228">Samavati, Faramarz</a>	['Computer Graphics', 'Interactive Games and Graphics', '3D Imaging and Modeling', 'Scientific Computations']
Scheidler, Renate	Professor	<a href="/info/cpsc/profiles/101-152968">Scheidler, Renate</a>	['Algorithmic and Computational Number Theory', 'Cryptography']
Sharlin, Ehud	Professor	<a href="/info/cpsc/profiles/102-3264">Sharlin, Ehud</a>	['Human-Robot Interaction', 'Tangible User Interfaces', 'Virtual Reality', 'Mixed Reality', 'Mobile Interfaces', 'Computer Games Interfaces', 'Human-Computer Interaction']
Shaw, Mildred Louise Gill	Professor Emeritus	<a href="/info/cpsc/profiles/102-3124">Shaw, Mildred Louise Gill</a>	[]
Stephenson, Benjamin	Teaching ProfessorAssociate Head (Operations)	<a href="/info/cpsc/profiles/102-3672">Stephenson, Benjamin</a>	[]
Tang, Anthony	Adjunct Associate Professor	<a href="/info/cpsc/profiles/102-10418">Tang, Anthony</a>	[]
Unger, Brian William	Professor Emeritus	<a href="/info/cpsc/profiles/102-3095">Unger, Brian William</a>	[]
Vize, Peter	Adjunct Professor	<a href="/info/cpsc/profiles/102-4533">Vize, Peter</a>	[]
Walker, Robert James	Professor	<a href="/info/cpsc/profiles/102-3636">Walker, Robert James</a>	['Software Evolution', 'Software Reuse', 'Empirical Software Engineering', 'Aspect-Oriented Programming']
Wang, Mea	Associate Professor	<a href="/info/cpsc/profiles/102-3322">Wang, Mea</a>	['Networking systems and algorithms; Practical applications of theoretical concepts; Quality of Services (QoS); Overlay and Peer-to-Peer protocols']
Willett, Wesley	Assistant ProfessorNSERC CRC TIER II Vis Analytic	<a href="/info/cpsc/profiles/1-6140837">Willett, Wesley</a>	['Information visualization, social computing, new media, and human computer interaction']
Williams, Michael Roy	Professor Emeritus	<a href="/info/cpsc/profiles/102-4361">Williams, Michael Roy</a>	[]
Williamson, Carey	Professor	<a href="/info/cpsc/profiles/102-3563">Williamson, Carey</a>	['Network Performance', 'Internet Protocols', 'Wireless Networks', 'Network Simulation']
Woelfel, Philipp	Associate ProfessorTier II NSER CRC RDA	<a href="/info/cpsc/profiles/102-3686">Woelfel, Philipp</a>	['Randomized Algorithms and Data Structures', 'Computational Complexity', 'Theory of Distributed Computing']
Wyvill, Brian Leslie Maurice	Professor Emeritus	<a href="/info/cpsc/profiles/102-3110">Wyvill, Brian Leslie Maurice</a>	[]
Zimmermann, Thomas	Adjunct Assistant Professor	<a href="/info/cpsc/profiles/102-3302">Zimmermann, Thomas</a>	[]
